################################
#....~~~~~~....................#
#....~~~~~~....................#
#....######....................#
#....#....#....................#
#.........#....................#
################################